100 100
3
0 5
99 2
80 3
29 99
1111000000000000000000000000000000000000000000000000000000000000000000000000000000000000000011111111
1100000000000000000000000000000011111111111111111111000000000000000000000000000000111111111111111111
1111110000000000000000000000000000000011111111111111111111111111111111111111000000000000000011111111
1100000000000000000000011111111100000000000000000000111111111111100000000000000111111111100000000000
1100000000000111111111111111100000000000000000000000000000000000000001111111000000000000000000001111
0000000000111110000000000010000000011110000000000000000000011111000000000011110000000000000000000011
1100000000000000011111111111110000000000000110000000000000000000111111111111000000000000000001111111
1000000000000000000000001111111110000000000000011111111111111111110000000000000000000000000000111111
1110000000000001111110000000000000001110000000000000000000000011100000000000000000011111111110000000
0000000000011111000000000000111000000000000000011110000000000011111000000000000000011000000000011111
1000000000000000010000000000000000001111000000000000001111000000000111111000000000011111110000000000
1000000000000001000000011100000000000111000000000001111110000000000011100000011110000000000000011111
1111110000000000001111110000000111110000000000111111111000000001111111110000000000011111110000000000
1000000000000001111100000000001111100000000001111110000000000000001111000000000000111110000000000011
1111000000000000000000111111111000000000000000000000000011111111000000000111111111110000000000011111
1000000000011111110000000000000001111111111111000000000111111100000000111111110000000000001111111111
1111110000000000000001111111111111111111100000000000000000111111111110000000000011111111100000000111
1100000000111111110000000001111111111110000011111111111100000000000000011111111111111100000000000000
0000000000000000000011111000000000111111111000000000000001111111111111111100000000000000011111111111
1000000000000000111111111110000000001111111111110000000111111111111111000000000111111111000000000111
1110000000000000011111000000000111111111111000000001111111111111111111111111111111111111000000000000
0000000111111110000000000011111111111111111111110000000000000000000000000000000000000000000001111110
1111000000011111111111000000000000000000000000000000000011111111000000000111111111111000000011110000
1111000000011111100000000000000111111111111111111110000000011111111111111111111100000000011111000001
0000000000000111100000000000000111111111111111111110000000011111111110000000000000111111000000011100
0000000000000111100000000000000111111111111111111110000000011111111110000000000000000000000000011100
0000000000000000000000000000000111000000000000001110000000011000000000000000111100000000000111000001
1110000000000000011111110000000000001111111111000000111111000000000111111110000000011111100000001111
0000000000000000011100000000000000111100000000000000001111111000000000001110000000000011110000000000
0000000000000000111110000000000000111100000000000000001111111000000000001111000000000011111110000000
1111000000000000000000000000000000000000000000000000000000000000000000000000000000000000000011111111
1100000000000000000000000000000011111111111111111111000000000000000000000000000000111111111111111111
1111110000000000000000000000000000000011111111111111111111111111111111111111000000000000000011111111
1100000000000000000000011111111100000000000000000000111111111111100000000000000111111111100000000000
1100000000000111111111111111100000000000000000000000000000000000000001111111000000000000000000001111
0000000000111110000000000010000000011110000000000000000000011111000000000011110000000000000000000011
1100000000000000011111111111110000000000000110000000000000000000111111111111000000000000000001111111
1000000000000000000000001111111110000000000000011111111111111111110000000000000000000000000000111111
1110000000000001111110000000000000001110000000000000000000000011100000000000000000011111111110000000
0000000000011111000000000000111000000000000000011110000000000011111000000000000000011000000000011111
1000000000000000010000000000000000001111000000000000001111000000000111111000000000011111110000000000
1000000000000001000000011100000000000111000000000001111110000000000011100000011110000000000000011111
1111110000000000001111110000000111110000000000111111111000000001111111110000000000011111110000000000
1000000000000001111100000000001111100000000001111110000000000000001111000000000000111110000000000011
1111000000000000000000111111111000000000000000000000000011111111000000000111111111110000000000011111
1000000000011111110000000000000001111111111111000000000111111100000000111111110000000000001111111111
1111110000000000000001111111111111111111100000000000000000111111111110000000000011111111100000000111
1100000000111111110000000001111111111110000011111111111100000000000000011111111111111100000000000000
0000000000000000000011111000000000111111111000000000000001111111111111111100000000000000011111111111
1000000000000000111111111110000000001111111111110000000111111111111111000000000111111111000000000111
1110000000000000011111000000000111111111111000000001111111111111111111111111111111111111000000000000
0000000111111110000000000011111111111111111111110000000000000000000000000000000000000000000001111110
1111000000011111111111000000000000000000000000000000000011111111000000000111111111111000000011110000
1111000000011111100000000000000111111111111111111110000000011111111111111111111100000000011111000001
0000000000000111100000000000000111111111111111111110000000011111111110000000000000111111000000011100
0000000000000111100000000000000111111111111111111110000000011111111110000000000000000000000000011100
0000000000000000000000000000000111000000000000001110000000011000000000000000111100000000000111000001
1110000000000000011111110000000000001111111111000000111111000000000111111110000000011111100000001111
0000000000000000011100000000000000111100000000000000001111111000000000001110000000000011110000000001
0000000000000000111110000000000000111100000000000000001111111000000000001111000000000011111110000000
1111000000000000000000000000000000000000000000000000000000000000000000000000000000000000000011111111
1100000000000000000000000000000011111111111111111111000000000000000000000000000000111111111111111111
1111110000000000000000000000000000000011111111111111111111111111111111111111000000000000000011111111
1100000000000000000000011111111100000000000000000000111111111111100000000000000111111111100000000000
1100000000000111111111111111100000000000000000000000000000000000000001111111000000000000000000001111
0000000000111110000000000010000000011110000000000000000000011111000000000011110000000000000000000011
1100000000000000011111111111110000000000000110000000000000000000111111111111000000000000000001111111
1000000000000000000000001111111110000000000000011111111111111111110000000000000000000000000000111111
1110000000000001111110000000000000001110000000000000000000000011100000000000000000011111111110000000
0000000000011111000000000000111000000000000000011110000000000011111000000000000000011000000000011111
1000000000000000010000000000000000001111000000000000001111000000000111111000000000011111110000000000
1000000000000001000000011100000000000111000000000001111110000000000011100000011110000000000000011111
1111110000000000001111110000000111110000000000111111111000000001111111110000000000011111110000000000
1000000000000001111100000000001111100000000001111110000000000000001111000000000000111110000000000011
1111000000000000000000111111111000000000000000000000000011111111000000000111111111110000000000011111
1000000000011111110000000000000001111111111111000000000111111100000000111111110000000000001111111111
1111110000000000000001111111111111111111100000000000000000111111111110000000000011111111100000000111
1100000000111111110000000001111111111110000011111111111100000000000000011111111111111100000000000000
0000000000000000000011111000000000111111111000000000000001111111111111111100000000000000011111111111
1000000000000000111111111110000000001111111111110000000111111111111111000000000111111111000000000111
1110000000000000011111000000000111111111111000000001111111111111111111111111111111111111000000000000
0000000111111110000000000011111111111111111111110000000000000000000000000000000000000000000001111110
1111000000011111111111000000000000000000000000000000000011111111000000000111111111111000000011110000
1111000000011111100000000000000111111111111111111110000000011111111111111111111100000000011111000001
0000000000000111100000000000000111111111111111111110000000011111111110000000000000111111000000011100
0000000000000111100000000000000111111111111111111110000000011111111110000000000000000000000000011100
0000000000000000000000000000000111000000000000001110000000011000000000000000111100000000000111000001
1110000000000000011111110000000000001111111111000000111111000000000111111110000000011111100000001111
0000000000000000011100000000000000111100000000000000001111111000000000001110000000000011110000000001
0000000000000000111110000000000000111100000000000000001111111000000000001111000000000011111110000000
1100000000000000011111111111110000000000000110000000000000000000111111111111000000000000000001111111
1000000000000000000000001111111110000000000000011111111111111111110000000000000000000000000000111111
1110000000000001111110000000000000001110000000000000000000000011100000000000000000011111111110000000
0000000000011111000000000000111000000000000000011110000000000011111000000000000000011000000000011111
1000000000000000010000000000000000001111000000000000001111000000000111111000000000011111110000000000
1000000000000001000000011100000000000111000000000001111110000000000011100000011110000000000000011111
1111110000000000001111110000000111110000000000111111111000000001111111110000000000011111110000000000
1000000000000001111100000000001111100000000001111110000000000000001111000000000000111110000000000011
1111000000000000000000111111111000000000000000000000000011111111000000000111111111110000000000011111
1000000000011111110000000000000001111111111111000000000111111100000000111111110000000000001111111111