20 30
3
0 8
7 7
19 19
11 16
111111110001100000001111111111
111100000011111100001111111111
111111000011110000001111111111
111111111000000011100011111111
111111111100001111110000100111
111111111000111110000000111111
111111000011110000001111111111
111111100000000011101111111111
111111111100000000001111111111
111111111100000000001111111111
111111110001100000001111111111
111100000011111100001111111111
111111000011110000001111111111
111111111000000011100011111111
111111111100001111110000100111
111111111000111110000000111111
111111000011110000001111111111
111111100000000011101111111111
111111111100000000001111111111
111111111100000000001111111111