20 30
3
0 8
7 7
19 19
11 16
000001110001100110001100111000
111100000010011100001100000011
100000010011110011001000000011
111000111000000011100011110000
100011111100001001110000100111
100000111000100010000000110000
110000000011001000000011100001
100001100000000011101100000011
100000111101111000001111000011
001110000000000000000000011001
111000000001100000000111100000
110000000000011100001110000011
110001000011110000001111100000
111100010000000111100010000111
100001000100001100110000100000
111001111000111110000000110001
110011000000001111001100110001
100111100011100000001100010001
110011110110011000001111000011
100000000000000000000000000111