8 10
2
2 1
7 2
4 7
1000100001
1100100011
0000100000
1000110001
1001111001
0001111000
0000110000
1100000011