100 100
4
5 0
10 0
15 0
20 0
99 99
0000000000000110000000000000001000010000000000000100000000000010000000000000000000000000001000000010
0000000000000000000000000000000000000000000000000000000001000000000000000000000000011100100000000000
0000000000010010010000000000000000000000010000000100000100000000000000000000000000010000000000000000
0000000000001000000000010000000000000000000000000000000000000000000010100000000000000000000010000000
0000000000000000000000001000000000010000000000010001000000000000000000000000000000000000000000000000
0000000000000010000000001000000000001000000000000011000000000000000000000000000000100010000001000000
0000000000000000000000000000000000000000010100000010000000000000100010000000000100001010000000000000
0000001010000000000000000000001100000000000000000000000000000000001000010000000000000000000000000000
0000000000000000000000001000010000000000000000000000000000001001001000000010000000000000000001000000
0000000000001000000000000000000000000000000000010000000000000000000000000000000001000000000000100000
0000000000000000000000000000000100000000100000000000000000001001000000000100010000000000000000000000
0100000000001000100000010001000000000000000000000000000000010000000000000000000000000000000000000000
0000000000100000000000000010000010000001010000000000001000000000000000000000000000000001000000000000
0000000000000000001000000001000000000000000000000000000000000000000000000000001000000000000000000000
0000000001000000000000000000000000000000000100000001100010000000000000000000000000000001100000000000
0010000000000000010000100001000000000010000000000000000100000000000000010000000000000000000000000000
0000000000000000000000000000100000000000000000000000010000000000000100000000001000001000000000000000
1000000000000000000000001000000000000000000010000000000000000000000000000000001000000010000000000000
0000001000000000000010000010000000000000000000000010000000000000000000000000000000000000010000000000
0000000000000000000000000000000000000000000000000000000000000000000000000000000000000000000000000000
0000000000000000000000010000000000000000000000000000100000000000000000010000000100000000000010000000
0000000000000000000000000000000000000000000000100100000000000000000000000001000000000000000000100000
0000000000000000000000000000001000000000100000000000000000010100000000000000000000000000000000000000
0000000000010000000000000100000010000100000000000010000000000000000010000000000010000000000000000000
1111111111111111111111111111111111111111111111111111111111111111111111111111111111111111111111111111
0000000100000000000000000001000000100000000000000000101100000000000000000000000000000000000001000000
0001000000000000000000000000000000001000000000000000000001000000000000000000000000000000000000000000
1000000000000000000000000000000000001000000000010000000000000000000000010000000000000000100000000000
0000000000000001000000000000000000000000000100000000000000000000000000000001000000000000001000000000
0000000000000000100000000000000000000000000000000000000000000001000000000000000000000000000001100100
0000000000000000000000000000000000000000000000000000000000000000100000000000000000001010000000000000
1000000010000000000000010000010000001000000000000000100001000000000000000000000000011000000000000000
0000000000000000000000000000001000000000000000010000000100000000000010000010000000000000000000000000
0000000000000000000000000000000000000010000000000000000001000000000000001000101000000100000000000000
0010010000000000000000000000000001000000000010100001000000000000000000000001000000000000000000000000
0000000000000000000000000000000000000000001000000000000000000001000000000000000100000000000001000000
0000010101000101000000000000000000000000000001000000000000010100000000000000000000000000000100000000
0010000000000000100000000000001100000000000000000000000000001000000100001000001000000000000000000000
0000000000000000000000000000000001000000000000000000010000000000000000000000000000000100000000000000
0000000000000000000000100010100000000000001000010000000000000000000000000000000000000000000000000000
0000000000000000000000000010000000000000000000000000000001000000001000000000000100000000100000000000
0000000000001100000000000000000100000000000000000000010000000000000010000000000000100000000000000000
0010000000000000000000000000000000000000000000000000000000000000000000000000000000000000000000000000
0000001000100100000100000000000000000000000000000000000000000000001000100100000000000000010000010000
0000000100000000000000000000000000000000000000000000000000000001000000000000000100001000000000000000
0000000000000000000010000000000100000100000000000000000000000000000000000000000000000000000001000000
0010000000000000000000000000000000000010000000000000000000010000010000000000001000000000001000000000
0000000000000000000000000000000000001000000000000000000010000011000000000000000000000000100010000000
0000000000000000000000000000000000000000000000000000000000000000000000000000000000000000000000000000
0000000010000000000000000001000000010000000000000001001000000000000000000000000100000000100000000000
0000000100000000000000000000000000000000000010001000000000000100000000000000000000000000001000000000
0000000000000000000000000000000010000000000010000000000000000000000000001001000000000000000000000010
0000000010010000000000000000000000000000000000010000000000000000000000000000000100001000000000000000
0000000000000000000001000100000000000001000000000010000000000000001000100000010000000100000000000010
0000000100000000100000000000000000000000000000000000000000000000000100000000000000000000000000000000
1000000000000000000010000000000000001000000000000000000000000000000010000100001000000000000000000000
0000000000000000000000000000000000000000000000000000000000000000000000100100000000000000000000000000
0000000000000000100001000000000000000000000000001000000000000000000000000000000000000000000000000000
0000000100000000000000000000000000000010000000000000000000000001000000000000000000000000000100000011
1000000000000000000000000010000000000000000000010000000000001000000000000000000000000000000000000000
0000000100010000000000000000000000000000000000001000000000000000000000000000000000010001000000100000
0000010000000001000000000000000000000000000000000000000010000000000000010000000000000000000000000000
0000000000000000000000000000100000000000000001100000000000001000000000000000000000000000000000000000
0000000000110011000000000000001100000000000000000000010000000000000000000000000000000000000000000000
0000000000000010000000000000000000000000000000010000000000000000000000000000110000001000000000000000
0000001001000000000000000000100000000000000100000000010000001000010000000000000000000000000000000000
0000001000000000000000000001000000000000000000000000000000000000000000000000000000000000000000000000
0000000000000000100000010001000000000001000100000010000000000000000000010100000001000000000100000100
0000000000000001000000000000000000000000000010000010000001001000000000000000000000000000000000000000
0000000000000000000000000000100000000000000000000000000000010000000000000001000100000000000000000000
0001000001000000001000000010000000000000000100000000000000000000000000100000000000001000000000000000
0000000000000000000000000000000000000010000000001000000000000001000000000000000000000000000000000000
0000000000000000000000000000000000000010000000000000000000000000000000000000000000000000000000000000
0000000000010000000000000000000000000000000000000000000000000000000000000000000000010000001001000000
0000000000000000000000000000000000000000000101000000000000001010001000000000000000000000000000000010
0101100000000000000000000000000000000000000000000000010000000000000100001000000010000000000000000000
0000000000000000000000000000000000000000000000000000000000000000000000000100000000000000000000010010
0000000001000000010000000100000010000000000001000000000100000000000000010010000000000000000000000000
0000000000000000000000010000000010001000000000000000001000000000000000000000000000000000000010000000
0001000000000000000110000000000001001000000000000000010000000000000000000000000000000000000000000001
0010000000000001010011000000001001000000000000100000100000000000000000000000000001000000000001000000
0000000000110000000101000000000000000001000000000000000000010000000001000000000000000000000000000000
0000000000000000000000000000010000000000010001000000000000000000000000000001000100000000010000000000
0000000000000000000000000000000000000000000000000000000000010000000000000000000000000000000000000000
0000001000000100000000001000000000000000000010000000000000000010000000000000000000000000000000000000
0001000000000000000000001000000100000000000000000000000000000000000100000010000000000000000000100000
0000000000100000000000000000001000100000000000000000000000000000000000000010000010000000000000000000
0000000000000000000000000000000000001000001000000100000000001000010000010000000000000000000010001000
0000100000000010000000000000000000000000000000010000000000000000000000000100000000000001000000000000
0000000000000000000100000000000010001000000000000000000000000100000000000100000000000000000000000000
0000010000000000000000000000000000000000000000100000000010000000000000000000000000000000000010000000
0000001000000000001000000000000010100000000000000000000000000000000000000000000000000010000000001000
0000000000000000000000000001000000000000000000000000000000000000000000000000000000000000010000011000
0000000000000000000000000000000100000000000000000000000000000000000000000000000000000000000000000000
0000001000000000000000000010000000000000000000000000000000000000010000000000000000000010001000010000
0000000000000000000000000000001000000000100000000000000000000000010000000000000010000000000000000000
0000000000010000000100000100000000000000000000000100000000000101001000000000000001000000000000000000
0000001000000000000001000000000000000010000010000000000000000000000000000000000000000000000100000000
0000010000001000000000000000000001000100000000000000000001000000100000100000000011000000000001000000
1000000000000000000000000000000000000000000000000000000000000000000000001000000000000000000100000000
